autospies.com	autospies	
autotraderclassics.com	AutoTrader_com	
bikeexif.com	bikeexif	
dmv.org	dmvorg	
truedelta.com	truedelta	
vwvortex.com	vwvortex	
dealbreaker.com	dealbreaker	
venturebeat.com	venturebeat	
wallstcheatsheet.com	wallstCS	
zerohedge.com	zerohedge	
globalgrind.com	GlobalGrind	
guestofaguest.com	guestofaguest	
gunaxin.com	gunaxin	
hecklerspray.com	hecklerspray	
io9.com	io9	
dlisted.com	itsdlisted	
kineda.com	kineda	
jezebel.com	mlcalderone	
radaronline.com	radar_online	
starpulse.com	starpulse	
avclub.com	TheAVClub	
theurbandaily.com	theurbandaily	
tmz.com	TMZ	
toofab.com	toofab	
uinterview.com	uinterview	
wetpaint.com	wetpainttv	
whosdatedwho.com	whosdatedwho	
x17online.com	x17online	
starcasm.net	starcasm	
acidcow.com	acidcow	
theawl.com	awl	
brobible.com	brobible	
screwattack.com	screwattack	
somethingawful.com	somethingawful	
theberry.com	theberrydotcom	
blogher.com	blogher	
boingboing.net	boingboing	
eater.com	Eater	
everyjoe.com	everyjoedotcom	
flavorwire.com	flavorwire	
fluther.com	fluther	
gothamist.com	gothamist	
kickstarter.com	kickstarter	
notalwaysright.com	notalwaysright	
personalliberty.com	personalliberty	
petapixel.com	PetaPixel	
ranker.com	ranker	
seriouseats.com	seriouseats	
sneakernews.com	sneakernews	
thechive.com	theCHIVE	
towleroad.com	tlrd	
americablog.com	americablog	
crooksandliars.com	crooksandliars	
dailykos.com	dailykos	
politico.com	politico	
redstate.com	RedState	
talkingpointsmemo.com	tpm	
wonkette.com	wonkette	
thinkprogress.org	thinkprogress	
kevinandamanda.com	kevinandamanda	
gearpatrol.com	gearpatrol	
jalopnik.com	jalopnik	
mouseplanet.com	mouseplanet	
9to5mac.com	9to5mac	
afterdawn.com	afterdawn	
daniweb.com	daniweb	
lifehacker.com	lifehacker	
searchengineland.com	sengineland	
thenextweb.com	thenextweb	
theverge.com	verge	
runningshoesguru.com	runningshoesgur	
uncrate.com	uncrate	
addictivetips.com	addtips	
evilbeetgossip.com	ebgossip	
realityblurred.com	realityblurred	
rickey.org	rickey	
prospect.org	theprospect	
greatschools.org	greatschools	
movieinsider.com	movieinsider	
movies.com	moviesdotcom	
rottentomatoes.com	rottentomatoes	
artsonia.com	artsonia	
zvents.com	zvents	
broadwayworld.com	broadwayworld	
jambase.com	jambase	
marcustheatres.com	marcus_theatres	
activediner.com	activediner	
bravotv.com	Bravotv	
cbn.com	CBNProducers	
clarkhoward.com	CLARKHOWARD	
drphil.com	DRPHIL	
eonline.com	eonline	
ewtn.com	ewtn	
history.com	history	
kqed.org	KQED	
mylifetime.com	mylifetime	
nbc.com	nbc	
oprah.com	oprah	
outdoorchannel.com	OutdChannel	
oxygen.com	oxygen	
rachaelrayshow.com	rachaelrayshow	
sidereel.com	sidereel	
southparkstudios.com	SouthPark	
syfy.com	syfy	
titantv.com	titantv	
today.com	todayshow	
tvfanatic.com	tvfanatic	
televisionwithoutpity.com	tvwithoutpity	
usanetwork.com	usa_network	
zap2it.com	zap2it	
g4tv.com	g4tv	
movieguide.org	movieguide	
radiocity.com	radiocity	
investorplace.com	investorplace	
forsalebyowner.com	forsalebyowner	
landwatch.com	landwatch	
lakehouse.com	lakehousedotcom	
lotterypost.com	lotterypost	
teamrankings.com	teamrankings	
poolhost.com	PoolHost_com	
boardgamegeek.com	boardgamegeek	
cheatcodes.com	cheatcodes	
cheatsguru.com	cheatsguru	
kotaku.com	DavidEllis	
destructoid.com	destructoid	
gamefront.com	gamefrontcom	
gametrailers.com	gametrailers	
gamezone.com	GameZoneOnline	
moddb.com	moddb	
n4g.com	n4g	
nintendolife.com	nintendolife	
operationsports.com	operationsports	
strategywiki.org	strategywiki	
escapistmagazine.com	TheEscapistMag	
twitch.tv	twitchtv	
vgchartz.com	vgchartz	
wowwiki.com	wowwiki	
lolking.net	LolKingDotNet	
planetminecraft.com	planetminecraft	
addictinggames.com	addictinggames	
addictinggames.com	addictinggames	
hi5.com	hi5	
wildtangent.com	playwildtangent	
aq.com	artixkrieger	
ninjakiwi.com	ninjakiwigames	
psu.com	psudotcom	
calorielab.com	calorielab	
health.com	goodhealth	
mensfitness.com	MensFitness	
prevention.com	preventionmag	
yogajournal.com	Yoga_Journal	
mydearvalentine.com	mydearvalentine	
caring.com	caring	
activebeat.com	ActiveBeat	
diabetes.org	AmDiabetesAssn	
autismspeaks.org	autismspeaks	
blackdoctor.org	blackdoctor	
dailystrength.org	daily_strength	
dlife.com	dlife	
drweil.com	drweil	
pharmdaily.com	pharmdaily	
pharmdaily.com	pharmdaily	
vitals.com	Vitals	
drugs.com	drugscom	
blisstree.com	blisstreedotcom	
bakerella.com	bakerella	
bigoven.com	bigoven	
cdkitchen.com	CDKitchen	
cookinglight.com	Cooking_Light	
eatingwell.com	eatingwell	
elanaspantry.com	elanaspantry	
finecooking.com	finecooking	
joyofbaking.com	joyofbaking	
keyingredient.com	keyingredient	
myrecipes.com	my_recipes	
simplyrecipes.com	simplyrecipes	
thekitchn.com	TheKitchn	
vegetariantimes.com	vegtimes	
winemag.com	wineenthusiast	
colourlovers.com	colourlovers	
craftstylish.com	craftstylish	
instructables.com	instructables	
makezine.com	make	
tipjunkie.com	tipjunkie	
earth911.com	earth911	
ecorazzi.com	ecorazzi	
grist.org	grist	
mongabay.com	mongabay	
mnn.com	mothernaturenet	
treehugger.com	TreeHugger	
worldwildlife.org	world_wildlife	
workingmother.com	_workingmother_	
akc.org	akcdoglovers	
babycenter.com	BabyCenter	
babynames.com	babynamesdotcom	
babynamewizard.com	BabyNameWizard	
beliefnet.com	beliefnet	
collegecandy.com	collegecandy	
elfster.com	elfster	
everydayfamily.com	Everyday_Family	
fitpregnancy.com	fitpregnancy	
gurl.com	gurldotcom	
horoscope.com	horoscopedotcom	
ivillage.com	iVillage	
justmommies.com	justmommies	
life123.com	life123	
lifetips.com	lifetips	
mademan.com	mademan	
mamapedia.com	mamapedia	
mentalfloss.com	mental_floss	
weegy.com	officialweegy	
parabebes.com	parabebes	
patheos.com	patheos	
shebudgets.com	shebudgets	
sunset.com	SunsetMag	
tarot.com	tarotcom	
womensforum.com	womensforum	
yourtango.com	yourtango	
joycemeyer.org	joycemeyer	
29secrets.com	29secrets	
latest-hairstyles.com	latesthair	
refinery29.com	refinery29	
thegloss.com	theglossdotcom	
trendhunter.com	trendhunter	
apartmenttherapy.com	AptTherapy	
myhomeideas.com	myhomeideas	
break.com	breakcom	
collegehumor.com	CollegeHumor	
dorkly.com	dorkly	
ebaumsworld.com	ebaumsworld	
gawker.com	gawker	
godlikeproductions.com	glptweets	
gocomics.com	gocomics	
holytaco.com	holytaco	
izismile.com	izismile	
listverse.com	listverse	
quibblo.com	Quizzes	
roosterteeth.com	RoosterTeeth	
smosh.com	smosh	
yourdailymedia.com	yourdailymedia	
gardenweb.com	gardenweb	
guitarworld.com	guitarworld	
lyricsmode.com	lyricsmode	
pianoworld.com	pianoworld	
roughstock.com	roughstock	
songlyrics.com	songlyrics	
deviantart.com	deviantART	
glogster.com	glogster	
laughingsquid.com	LaughingSquid	
lifetouch.com	lifetouch	
addictinginfo.org	AddInfoOrg	
americanthinker.com	americanthinker	
usconstitution.net	ezoic	
thegatewaypundit.com	GenOpportunity	
humanevents.com	humanevents	
humanevents.com	humanevents	
mrconservative.com	MrConservative_	
nationalreview.com	nro	
politicalwire.com	politicalwire	
politicususa.com	politicususa	
politifact.com	politifact	
rushlimbaugh.com	rushlimbaugh	
upworthy.com	upworthy	
weeklystandard.com	weeklystandard	
wheresgeorge.com	wheresgeorge	
comicbookresources.com	cbr	
goodreads.com	goodreads	
webelements.com	periodic_table	
popsci.com	PopSci	
sciencebuddies.org	ScienceBuddies	
sciencedaily.com	sciencedaily	
tested.com	testedcom	
universetoday.com	universetoday	
androidcentral.com	androidcentral	
appleinsider.com	appleinsider	
dvice.com	dvice	
gizmodo.com	gizmodo	
hackaday.com	hackaday	
howtogeek.com	howtogeeksite	
infoworld.com	infoworld	
theinquirer.net	INQ	
itworld.com	itworld	
macrumors.com	MacRumors	
technologyreview.com	techreview	
thetech.org	TheTechMuseum	
techreport.com	thetechreport	
freekibble.com	freekibble	
redcross.org	redcross	
takepart.com	takepart	
movie-moron.com	AstroRobby	
bettyconfidential.com	bettybuzz	
clker.com	clkercom	
cutoutandkeep.net	cutoutandkeep	
dickmorris.com	DickMorrisTweet	
dornob.com	dornobdesign	
crochetpatterncentral.com	ezoic	
knittingpatterncentral.com	ezoic	
fredmiranda.com	fredmirandacom	
grandparents.com	grandparentscom	
lookbook.nu	lookbook	
construction.com	mhconstruction	
pregnancy.org	pregnancyorg	
publishersweekly.com	PublishersWkly	
quizfarm.com	quizfarm	
regretfulmorning.com	regretfulmorn	
religioustolerance.org	ReligiousTol	
hannity.com	seanhannity	
doggies.com	theDogDen	
aish.com	yourjudaism	
4shared.com	4shared	
hiphopdx.com	hiphopdx	
hotnewhiphop.com	hotnewhiphop	
kididdles.com	kididdles	
livemixtapes.com	livemixtapes	
okayplayer.com	okayplayer	
songza.com	songza	
soundclick.com	soundclick	
taylorswift.com	taylorswift13	
twit.tv	twit	
wetransfer.com	wetransfer	
8tracks.com	8tracks	
broadcastify.com	broadcastify	
coasttocoastam.com	coasttocoastam	
elvisduran.com	ElvisDuranShow	
kcrw.com	kcrw	
live365.com	live365	
radioreference.com	radioreference	
tunegenie.com	tunegenie	
tunein.com	tunein	
weei.com	WEEI	
z100.com	z100	
bigthink.com	bigthink	
blip.tv	blip	
contactmusic.com	Contactmusic	
devour.com	devour	
flixxy.com	flixxydotcom	
grindtv.com	GrindTV	
irokotv.com	irokotv	
justin.tv	justintv	
metacafe.com	Metacafe	
ovguide.com	OVGuide	
powerblocktv.com	powerblocktv	
snotr.com	snotr	
streetfire.net	Streetfire	
videobash.com	videobash	
music-lyrics-gospel.com	ezoic	
killsometime.com	killsometimecom	
newscientist.com	newscientist	
adage.com	adage	
adweek.com	adweek	
allyou.com	allyou	
alternet.org	AlterNet	
athlonsports.com	athlonsports	
celebritytoob.com	celebritytoob	
celebritytoob.com	celebritytoob	
chicagomag.com	chicagomag	
dimemag.com	dimemag	
ew.com	ew	
fieldandstream.com	fieldandstream	
gossiponthis.com	gossiponthis	
instyle.com	InStyle	
lonny.com	lonnymag	
mania.com	mania	
maxim.com	maximmag	
pagesix.com	pagesix	
pastemagazine.com	pastemagazine	
peopleenespanol.com	peopleenespanol	
people.com	peoplemag	
realsimple.com	RealSimple	
reason.com	reason	
rollingstone.com	rollingstone	
salon.com	salon	
slamonline.com	slamonline	
southernliving.com	southern_living	
stylebistro.com	stylebistro	
teenidols4you.com	teenidols4you	
thenation.com	THENATION	
theweek.com	theweek	
usmagazine.com	usweekly	
vibe.com	vibemagazine	
weeklyworldnews.com	weeklyworldnews	
womenshealthmag.com	WomensHealthMag	
247wallst.com	247wallst	
abc15.com	abc15	
abc2news.com	abc2news	
abcactionnews.com	abcactionnews	
accesshollywood.com	accesshollywood	
advfn.com	advfn	
ajc.com	ajc	
al.com	aldotcom	
allafrica.com	allafrica	
alltop.com	alltop	
animenewsnetwork.com	anime	
arkansasonline.com	arkansasonline	
arktimes.com	arktimes	
austinchronicle.com	austinchronicle	
azcentral.com	azcentral	
azfamily.com	azfamily	
berkshireeagle.com	berkshireeagle	
billingsgazette.com	billingsgazette	
bleacherreport.com	bleacherreport	
breakingnews.com	breakingnews	
nbcnews.com	breakingnews	
socialmediatoday.com	britopian	
nbcsports.com	CBTonNBC	
chicoer.com	chicoer	
citypages.com	citypages	
cleveland.com	clevelanddotcom	
cnbc.com	cnbc	
cnsnews.com	cnsnews	
courierpress.com	courierpress	
csmonitor.com	CSMonitor	
trib.com	cstribune	
dailycaller.com	dailycaller	
dailycamera.com	dailycamera	
darkhorizons.com	darkhorizons	
daytondailynews.com	daytondailynews	
washingtonexaminer.com	dcexaminer	
delcotimes.com	delcotimes	
denverpost.com	denverpost	
westword.com	denverwestword	
deseretnews.com	deseretnews	
digitalspy.com	digitalspyus	
djournal.com	djournal	
drudgereport.com	DRUDGE	
elnuevoherald.com	elnuevoherald	
elpasotimes.com	elpasotimes	
eurweb.com	eurweb	
fark.com	fark	
flightstats.com	flightstats	
fortmilltimes.com	fortmilltimes	
foxsports.com	foxsports	
fresnobee.com	fresnobee	
glennbeck.com	glennbeck	
globegazette.com	globegazette	
hanfordsentinel.com	hanfordsentinel	
heraldextra.com	heraldextra	
kentucky.com	heraldleader	
heraldnet.com	heraldnet	
hitfix.com	hitfix	
houstonpress.com	houstonpress	
oregonlive.com	hssports_olive	
hutchnews.com	hutchnews	
independent.co.uk	Independent	
inforum.com	inforum	
insidebayarea.com	insidebayarea	
islandpacket.com	islandpacket	
jamaicaobserver.com	jamaicaobserver	
journalstar.com	JournalStarNews	
journaltimes.com	journaltimes	
kansas.com	kansasdotcom	
kcrg.com	kcrg	
kiplinger.com	kiplinger	
knoxnews.com	knoxnews	
ktvu.com	ktvu	
lacrossetribune.com	lacrossetribune	
dailynews.com	ladailynews	
laist.com	laist	
lancasteronline.com	lancasteronline	
larrybrownsports.com	LBSports	
legacy.com	LegacyObits	
lehighvalleylive.com	lehighvalley	
liveleak.com	liveleak	
ljworld.com	ljworld	
macombdaily.com	macombdaily	
masslive.com	MassLiveHS	
mcclatchydc.com	McClatchyDC	
mediotiempo.com	mediotiempo	
mhsaa.com	mhsaa	
miamiherald.com	miamiherald	
miaminewtimes.com	miaminewtimes	
minyanville.com	minyanville	
mlive.com	mlive	
modbee.com	modbee	
montereyherald.com	montereyherald	
mtstandard.com	mtstandard	
mydailymoment.com	mydailymoment	
nashvillescene.com	nashvillescene	
nationalgeographic.com	NatGeo	
nbcbayarea.com	nbcbayarea	
nbcconnecticut.com	nbcconnecticut	
nbcdfw.com	nbcdfw	
nbcwashington.com	nbcwashington	
nesn.com	nesn	
newburyportnews.com	newburyportnews	
news9.com	news9	
newsbusters.org	newsbusters	
newsobserver.com	newsobserver	
newsok.com	newsok	
newson6.com	newson6	
newstribune.com	newstribune	
nj.com	njdotcom	
nola.com	nolanews	
wn.com	NTDTelevision	
nwitimes.com	nwi	
nydailynews.com	nydailynews	
omaha.com	OWHnews	
pantagraph.com	pantagraph	
pennlive.com	pennlive	
phoenixnewtimes.com	phoenixnewtimes	
thepostgame.com	Post_Game	
postandcourier.com	postandcourier	
poststar.com	poststar	
presstelegram.com	presstelegram	
rantsports.com	RantSports	
rawstory.com	rawstory	
rapidcityjournal.com	RCJournal	
registerguard.com	registerguard	
riverfronttimes.com	riverfronttimes	
deadspin.com	RonFrancis10	
timesdispatch.com	rtdnews	
salemnews.com	salemnews	
salisburypost.com	salisburypost	
santamariatimes.com	santamariatimes	
satelliteguys.us	satelliteguys	
sbsun.com	sbsun	
tdn.com	ScotHeisel	
sandiegoreader.com	sdreader	
seattletimes.com	seattletimes	
sfweekly.com	sfweekly	
sgvtribune.com	sgvtribune	
silive.com	silivedotcom	
sanluisobispo.com	slotribune	
sportsgrid.com	sportsgrid	
azstarnet.com	starnet	
startribune.com	startribune	
statesman.com	statesman	
stltoday.com	stltoday	
thestranger.com	strangerpromo	
streetinsider.com	Street_Insider	
streetauthority.com	streetauthority	
sugarscape.com	sugarscape	
sunherald.com	sunherald	
surfline.com	surfline	
syracuse.com	syracusedotcom	
tcpalm.com	tcpalm	
teen.com	teen	
theadvocate.com	theadvocate	
economist.com	TheEconomist	
thefiscaltimes.com	thefiscaltimes	
thegrio.com	theGrio	
thehill.com	thehill	
theindychannel.com	theindychannel	
thenewstribune.com	thenewstribune	
theoaklandpress.com	theoaklandpress	
charlotteobserver.com	theobserver	
theolympian.com	theolympian	
theonion.com	TheOnion	
thesouthern.com	thesouthern	
thestate.com	thestate	
thesunchronicle.com	thesunchronicle	
thetandd.com	thetandd	
abovethelaw.com	TLLB2013	
topspeed.com	topspeed	
triblive.com	triblive	
tribstar.com	tribstar	
tulsaworld.com	tulsaworld	
vagazette.com	vagazette	
vcstar.com	vcstar	
villagevoice.com	villagevoice	
wcfcourier.com	wcfcourier	
washingtoncitypaper.com	wcp	
wcpo.com	wcpo	
newsnet5.com	wews	
wfmz.com	wfmztraffic	
wftv.com	wftv	
wgbh.org	WGBH	
whittierdailynews.com	WhittierNews	
wkyt.com	WKYT	
wndu.com	wndu	
wnd.com	worldnetdaily	
wowt.com	WOWT6News	
wptv.com	wptv	
wsaz.com	wsaz	
wsbtv.com	wsbtv	
wsoctv.com	WSOC_TV	
washingtontimes.com	WTCommunities	
wxyz.com	wxyzdetroit	
yardbarker.com	Yardbarker	
zimbio.com	zimbio	
firsttoknow.com	befirsttoknow	
examiner.com	examinercom	
newser.com	Newser	
inquisitr.com	theinquisitr	
topix.com	topix	
truthdig.com	truthdig	
whatculture.com	whatculture	
davisenterprise.com	alldenews	
bismarcktribune.com	bistrib	
blastr.com	blastr	
chicagoreader.com	Chicago_Reader	
cio.com	CIOonline	
citypaper.com	city_paper	
dailybreeze.com	DailyBreezeNews	
dfw.com	dfwdotcom	
democratherald.com	dhnews	
duluthnewstribune.com	duluthnews	
eagletribune.com	EagleTrib	
fredericknewspost.com	FNP_espanol	
fortwayne.com	FortWayne_com	
gazette.net	Gazette_Net	
golfweek.com	GolfweekMag	
gazettetimes.com	gtnews	
helenair.com	helenaironline	
herald-review.com	heraldandreview	
hispanicbusiness.com	HispanicBizMag	
dailybulletin.com	ivdailybulletin	
johnsoncitypress.com	JCPress	
kirotv.com	KIRO7Seattle	
kxly.com	kxly4news	
lowellsun.com	lowellsunnews	
pottsmerc.com	MercuryX	
miami.com	Miamicom	
commentarymagazine.com	mrubin1971	
napavalleyregister.com	NapaRegister	
nationalenquirer.com	NatEnquirer	
nbcmiami.com	nbc6	
nbclosangeles.com	nbcla	
naplesnews.com	ndn	
news-gazette.com	news_gazette	
fredericksburg.com	NewsInTheBurg	
news-sentinel.com	newssentinel	
onenewspage.com	One_News_Page	
observer-reporter.com	oronline	
palmbeachpost.com	pbpost	
pinknews.co.uk	PinkNews	
powdermag.com	powdermagazine	
qctimes.com	qctimes	
rasmussenreports.com	Rasmussen_Poll	
bestofneworleans.com	search	
auburnpub.com	The_Citizen	
anorak.co.uk	TheAnorak	
magicvalley.com	twinfallstn	
cakecentral.com	cakecentral	
foodgawker.com	foodgawker	
findthebest.com	findthebest	
johnsonville.com	JvilleKitchens	
cvent.com	cvent	
ihigh.com	ihigh	
pbworks.com	pbworks	
obeo.com	Obeo	
bismanonline.com	bismanonline	
elclasificado.com	elclasificado	
encuentra24.com	encuentra24	
geebo.com	gregcollier	
gunbroker.com	GunBroker	
icollector.com	icollector	
ioffer.com	ioffer	
purplewave.com	purplewave	
shopgoodwill.com	shopgoodwill	
alibris.com	alibris	
dummies.com	fordummies	
aarons.com	AaronsInc	
mobileburn.com	mobileburn	
solidsignal.com	SolidSignalCom	
fandango.com	fandango	
giantfoodstores.com	giantfoodstores	
bandcamp.com	bandcamp	
cinemablend.com	cinemablend	
finegardening.com	finegardening	
mowersdirect.com	mowersdirect	
wayfair.com	wayfair	
kicksonfire.com	kicksonfire	
pickyourshoes.com	pickyourshoes	
airsoftgi.com	airsoftgi	
artfire.com	Artfire	
equinenow.com	equinenow	
mycomicshop.com	mycomicshop	
mywedding.com	myweddingdotcom	
zibbet.com	zibbet	
mtbr.com	mtbr	
allaboutdance.com	all_about_dance	
rackroomshoes.com	rackroomshoes	
baseballamerica.com	baseballamerica	
mlbdailydish.com	mlbdailydish	
insidehoops.com	insidehoops	
kusports.com	kusports	
yalebulldogs.com	YaleAthletics	
fftoolbox.com	fftoolbox	
fftoolbox.com	fftoolbox	
rotoworld.com	rotoworld_bb	
247sports.com	247Sports	
colts.com	colts	
golfchannel.com	GolfChannel	
golfwrx.com	golfwrx	
golf.com	si_golf	
worldgolf.com	worldgolf	
nhl.com	nhl	
athletic.net	AthleticNet	
fansided.com	fansided	
outdoorlife.com	outdoorlife	
outsports.com	outsports	
milesplit.com	milesplit	
mmafighting.com	MMAFighting	
mmamania.com	mmamania	
livesoccertv.com	livesoccertv	
usta.com	usta	
marathonguide.com	MarathonGdotcom	
mmaweekly.com	mmaweeklycom	
alcatrazcruises.com	alcatrazcruises	
brownstoner.com	brownstoner	
colorado.com	colorado	
desertusa.com	desertusa	
thefuntimesguide.com	FunTimesGuide	
laweekly.com	laweekly	
louisianatravel.com	louisianatravel	
tnvacation.com	tnvacation	
travelok.com	travelok	
travelwisconsin.com	TravelWI	
visitflorida.com	visitflorida	
visitpa.com	visitpa	
washingtonian.com	washingtonian	
yankeemagazine.com	yankeemagazine	
shermanstravel.com	shermanstravel	
luxurylink.com	luxurylink	
sixflags.com	sixflags	
fodors.com	fodorstravel	
frommers.com	FrommersTravel	
flightaware.com	flightaware	
bedandbreakfast.com	bnblovers	
dallasobserver.com	dallas_observer	
nyc.com	newyorkcity	
nycgovparks.org	nycparks	
oyster.com	oysterhotels	
michigan.org	puremichigan	
crackberry.com	CrackBerry	
everythingicafe.com	everythingicafe	
youmail.com	youmail	
myxer.com	myxer	
1011now.com	1011_News	
11points.com	11points	
140proof.com	140proof	
vanishingtattoo.com	1tattootribe	
indianasnewscenter.com	21AliveWPTA	
digsdigs.com	2digs	
2dopeboyz.com	2dopeposts	
365greetings.com	365greetings	
5dollardinners.com	5dollardinners	
5gig.com	5gig	
wwnytv.com	7newsfox28	
7x7.com	7x7	
813area.com	813area	
92q.com	92QJamsBmore	
937thebull.com	937thebull	
kysdc.com	939wkys	
theboxhouston.com	979thebox	
9to5google.com	9to5google	
9to5toys.com	9to5toys	
kvia.com	abc7breaking	
abesmarket.com	abesmarket	
acmepackingcompany.com	acmepackingco	
actionnewsjax.com	actionnewsjax	
addictedtoquack.com	addictedtoquack	
afamilyfeast.com	afamilyfeast	
allaccess.com	allaccess	
alleydog.com	alleydog_dotcom	
allfortennessee.com	allfortennessee	
alligatorarmy.com	alligatorarmy	
allkidsnetwork.com	allkidsnetwork	
alphamom.com	alphamom	
altpress.com	altpress	
at40.com	AmericanTop40	
ammoland.com	ammoland	
ammoseek.com	ammoseek	
anabolicminds.com	anabolicminds	
ancientfaces.com	ancientfaces	
androidpolice.com	AndroidPolice	
androidtablets.net	androidtablet	
anediblemosaic.com	anediblemosaic	
animalnewyork.com	animalnewyork	
appadvice.com	appadvice	
appshopper.com	appshopper	
aqha.com	aqha	
archdaily.com	archdaily	
archinect.com	archinect	
areavoices.com	areavoices	
arlnow.com	ARLnowDOTcom	
arrowheadaddict.com	arrowheadaddict	
arrowheadpride.com	arrowheadpride	
artistserver.com	artistserver	
artofmanliness.com	artofmanliness	
askamanager.org	askamanager	
askubuntu.com	askubuntu	
straightfromthea.com	ATLien	
austinist.com	austinist	
aviewfrommyseat.com	aviewfrommyseat	
awfulannouncing.com	awfulannouncing	
a-z-animals.com	azanimals	
buckys5thquarter.com	B5Q	
baby2see.com	Baby2see	
babynamegenie.com	babynamegenie	
badappreviews.com	badappreviews	
badassdigest.com	badassdigest	
badlefthook.com	badlefthook	
balleralert.com	balleralert	
ballerstatus.com	ballerstatus	
bassmaster.com	BASS_nation	
bassresource.com	bassresourcecom	
batman-news.com	BatmanNewsCom	
battleredblog.com	battleredblog	
beacontheatre.com	beacontheatre	
beautyrest.com	beautyrest	
belletire.com	belletire	
berecruited.com	beRecruited	
berkeleyside.com	berkeleyside	
bestteenpoems.com	bestteenpoems	
betcheslovethis.com	betcheslovethis	
bethenny.com	bethenny	
boltsfromtheblue.com	BFTB_Chargers	
blackgirllonghair.com	bglhonline	
biggirlssmallkitchen.com	BGSK	
bigblueview.com	bigblueview	
bigcatcountry.com	bigcatcountry	
bikerumor.com	bikerumor	
bilerico.com	bilerico	
billhighway.com	billhighway	
billyjoel.com	billyjoel	
bizpacreview.com	BIZPACReview	
brooklynflea.com	bkflea	
thewirecutter.com	blam	
blazersedge.com	blazersedge	
bleedinggreennation.com	BleedingGreen	
blessyouboys.com	blessyouboys	
bloggingtheboys.com	bloggingtheboys	
blogmybrain.com	blogmybrain	
bloguin.com	bloguin	
bloodyelbow.com	BloodyElbow	
boardingarea.com	boardingarea	
bobborst.com	bobborst	
boiseweekly.com	boiseweekly	
boldride.com	boldride	
bookriot.com	bookriot	
burntorangereport.com	bor	
bostonmagazine.com	BostonMagazine	
brandeating.com	brandeating	
brevilleusa.com	brevilleusa	
brickset.com	brickset	
bridalguide.com	bridalguidemag	
brightnest.com	brightnest	
brightscope.com	brightscope	
bringatrailer.com	bringatrailer	
brokelyn.com	brokelyn	
bromygod.com	BroMyGawd	
bruinsnation.com	BruinNation	
bubblynaturecreations.com	BubblyNature	
bucsnation.com	Bucs_Nation	
budget101.com	budget101	
buffalorumblings.com	BuffRumblings	
bulletproofexec.com	bulletproofexec	
bustedcoverage.com	bustedcoverage	
cablemover.com	cablemover	
cagepotato.com	cagepotatomma	
cagesideseats.com	cagesideseats	
cakesdecor.com	cakesdecor	
camelcamelcamel.com	camelcamelcamel	
cannabis.com	cannabis_com	
canonrumors.com	canonrumorsguy	
capitalnewyork.com	capitalnewyork	
carbonated.tv	carbonatedtv	
cardchronicle.com	cardchronicle	
carolinalive.com	carolinalive	
deliciouslyorganic.net	CarrieVitt	
carrotsncake.com	carrotsncake	
catscratchreader.com	CatScratchReadr	
newsplex.com	CBS19	
celiaccentral.org	CeliacAwareness	
celinedion.com	celinedion	
celticsblog.com	celticsblog	
channelguidemagblog.com	ChannelGuide	
charismamag.com	charismamag	
checkiday.com	checkiday	
chickensintheroad.com	ChickensintheRd	
chinasmack.com	chinasmack	
choosehelp.com	choosehelp	
christianacare.org	christianacare	
christiancinema.com	christiancinema	
christianforums.com	christianforums	
cincinnatiusa.com	cincinnatiusa	
cinemassacre.com	cinemassacre	
cities2night.com	cities2night	
clclt.com	cl_charlotte	
classiccars.com	classiccars_com	
cleantechnica.com	cleantechnica	
clevescene.com	Cleveland_Scene	
closetcooking.com	ClosetCooking	
clutchfans.net	clutchfans	
cnycentral.com	cnycentral	
coastalliving.com	coastalliving	
collegespun.com	CollegeSpun	
thisiscolossal.com	colossal	
comfortablefood.com	comfortablefood	
comicbook.com	ComicBookdotcom	
columbiamissourian.com	CoMissourian	
conceptcarz.com	conceptcarz	
constantchatter.com	constantchatter	
cookieandkate.com	cookieandkate	
coolhunting.com	coolhunting	
coolmaterial.com	coolmaterial	
coolmompicks.com	coolmompicks	
copyblogger.com	copyblogger	
coreperformance.com	coreperformance	
cornnation.com	cornnation	
corporette.com	corporette	
cougcenter.com	cougcenter	
countrymusicontour.com	countryontour	
craftgawker.com	craftgawker	
creativewithkids.com	CreateWithKids	
crisismagazine.com	CrisisMag	
crushable.com	crushabledotcom	
cupcakeproject.com	cupcakeproject	
curbed.com	Curbed	
cutegirlshairstyles.com	CuteGirlHair	
d3football.com	d3football	
dailyburn.com	dailyburn	
dailyinfographic.com	DailyInfographc	
dailynorseman.com	DailyNorseman	
dailyhoroscope.com	dailyscopes	
dance.net	dancedotnet	
dandb.com	dandb	
dyslexia.com	DavisDyslexia	
dawgsbynature.com	dawgsbynature	
dcist.com	dcist	
ddotomen.com	ddotomen	
deadlinedetroit.com	deadlinedetroit	
debbieschlussel.com	debbieschlussel	
deliciousobsessions.com	deliciousobsess	
dezeen.com	dezeen	
digitalromanceinc.com	digital_romance	
dinarguru.com	dinarguru	
dinneralovestory.com	DinnerLoveStory	
discoverlosangeles.com	discoverLA	
disinfo.com	disinfo	
districtlines.com	district_lines	
thehappierhomemaker.com	DIYMelissa	
do512.com	do512	
dodgersnation.com	dodgersnation	
dollarstorecrafts.com	dollarcraft	
dormstormer.com	dormstormer	
my.jobs	dotjobsuniverse	
downrightnow.com	downrightnow	
drfranklipman.com	drfranklipman	
droid-life.com	droid_life	
dudeiwantthat.com	dudeiwantthat	
dwell.com	dwell	
eastbayexpress.com	eastbayexpress	
eastoftheweb.com	eastoftheweb	
eatingrules.com	eatingrules	
eatliverun.com	eatliverun	
ebizmba.com	ebizmba	
everydayshouldbesaturday.com	edsbs	
ehardhat.com	ehardhat	
electronicmidwest.com	electronicmidw	
elev8.com	elev8official	
elevenwarriors.com	elevenwarriors	
emsworld.com	EMSWorldNews	
endlesssimmer.com	endlesssimmer	
engineerjobs.com	engineerjobs	
escapehere.com	escapehere_com	
eshakti.com	eshakti	
eskimopress.com	eskimopress	
etfdailynews.com	etfdailynews	
everydaymaven.com	everydaymaven	
everytrail.com	everytrail	
exploregeorgia.org	exploregeorgia	
cummingsstudyguides.net	ezoic	
ezstream.com	ezstream	
fakeshoredrive.com	fakeshoredrive	
fame10.com	fame10_com	
familyshare.com	familyshare	
famoushookups.com	famoushookups	
fanlala.com	fanlala	
fashionista.com	Fashionista_com	
fertilethoughts.com	fertilethoughts	
fertilityauthority.com	fertilityauthor	
finehomebuilding.com	fhbweb	
fieldgulls.com	fieldgulls	
firehouse.com	FirehouseNews	
firefighternation.com	firenation	
fishwrapper.com	fishwrapped	
fitclick.com	fitclick	
fitsnews.com	fitsnews	
flexonline.com	flex_magazine	
flor.com	flor	
flotrack.org	flotrack	
flowrestling.org	flowrestling	
flyingmag.com	FlyingMagazine	
fashionnstyle.com	FNStylecom	
handmadecharlotte.com	followcharlotte	
foodieblogroll.com	foodieblogroll	
fooducate.com	fooducate	
nationalfootballpost.com	FootballPost	
catholicculture.org	FormTheCulture	
forwardprogressives.com	ForwardProgs	
fox21news.com	fox21news	
fox23.com	fox23	
thefeaturedcreature.com	ftcreature	
funnyvinevideos.com	FunnyVineVids	
furiousfanboys.com	furiousfanboys	
fwd.us	fwd_us	
gaf.com	gafroofing	
gajitz.com	gajitz	
gamedayr.com	gamedayr	
gamerescape.com	gamerescape	
gamewise.co	Gamewise_co	
ganeshaspeaks.com	ganeshaspeaks	
goodbullhunting.com	GBHunting	
gcaptain.com	gcaptain	
gearnuke.com	gearnuke	
geekdad.com	geekdads	
geeksofdoom.com	geeksofdoom	
geekwire.com	geekwire	
electricgeneratorsdirect.com	GeneratorsDirec	
getcrocked.com	getcrocked	
geteventjobs.com	geteventjobs	
grandforksherald.com	gfherald	
glutenfreeonashoestring.com	gfshoestring	
giantlife.com	giant_life	
giphy.com	giphy	
girlschase.com	girlschase	
giveforward.com	giveforward	
goodlifeeats.com	goodlifeeats	
goodmenproject.com	goodmenproject	
goshtube.com	goshtube	
gossipextra.com	gossipextra	
gourmetrecipe.com	Gourmandia	
greatist.com	greatist	
greekchat.com	greekchat	
greekrank.com	greekrank	
greenlitebites.com	greenlitebites	
greginhollywood.com	greginhollywood	
gtaforums.com	gtanet	
gta4.net	gtanet	
gtav.net	gtanet	
gulflive.com	gulflive	
gunssavelives.net	Guns_Save_Lives	
hancinema.net	hancinema	
hasitleaked.com	hasitleaked	
hauteliving.com	hauteliving	
hbcudigest.com	hbcudigest	
healthyaperture.com	healthyaperture	
hellogiggles.com	hellogiggles	
hercampus.com	hercampus	
higherone.com	higherone	
myonemoney.com	higherone	
hitchedmag.com	hitchedmag	
hodinkee.com	hodinkee	
hogshaven.com	hogshaven	
hollywoodtake.com	hollywoodtake_	
honeybearlane.com	honeybearlane	
honolulumagazine.com	honolulumag	
hoosierhomemade.com	hoosierhomemade	
horoscopo.com	HoroscopeEsp	
shitbrix.com	horseheadhuffer	
indyhiphop.com	Hot963	
hothothoops.com	hothothoops	
bottomlinepublications.com	HouseholdMagic	
huskermax.com	huskermax	
hustlebelt.com	hustlebelt	
hyperallergic.com	hyperallergic	
ibtimes.co.in	ibtimesindia1	
icy-veins.com	icyveinscom	
idesigntimes.com	idesigntimes	
ifish.net	ifishjennie	
igta5.com	iGTA5	
ikeafans.com	ikeafans	
illroots.com	illroots	
ilpuncut.com	ilpvideo	
imore.com	iMore	
impactnews.com	impactnews	
impactwrestling.com	impactwrestling	
indexmundi.com	indexmundi	
indiancountrytodaymedianetwork.com	indiancountry	
infarrantlycreative.net	infarrantly	
insidethehall.com	insidethehall	
inthesetimes.com	inthesetimesmag	
intothegloss.com	intothegloss	
iphoneforums.net	iphone4forum	
ireporterstv.co	ireporterstv	
irishcentral.com	irishcentral	
iseek.org	iseekMN	
islamicity.com	islamicity	
islands.com	islandsmagazine	
itproportal.com	itproportal	
itsybitsysteps.com	itsybitsysteps	
jamesaltucher.com	jaltucher	
theglitterguide.com	javascripts	
jewishjournal.com	jewishjournal	
myjewishlearning.com	jewlearn	
journalgazette.net	jgfortwayne	
jobscore.com	jobscore	
joonbug.com	JoonbugBuzz	
jamespatterson.com	JP_Books	
capitolhillseattle.com	jseattle	
julieseatsandtreats.com	JuliesEatsTreat	
justdogbreeds.com	justdogbreeds	
k12reader.com	k12reader	
katheats.com	katheats	
keenspot.com	keenspot	
kellehampton.com	kellehampton	
kesq.com	kesq	
kfiam640.com	kfiam640	
khanapakana.com	khanapakana	
khq.com	KHQLocalNews	
kicksdeals.com	kicksdeals	
kitchenstewardship.com	kitchenstew	
kjrh.com	kjrh2hd	
klout.com	klout	
kmbz.com	KMBZradio	
knockoffdecor.com	knockoffdecor	
knoworthy.com	knoworthy	
kolotv.com	KOLO8	
kpvi.com	kpvi	
krdo.com	KRDONC13	
rageagainsttheminivan.com	kristenhowerton	
mynews4.com	KRNV	
ktvz.com	ktvz	
kveller.com	kveller	
kwch.com	kwch12	
kwtx.com	kwtx	
kxii.com	KXIITV	
lapatilla.com	la_patilla	
louisianasportsman.com	LAhuntnfish	
lakersnation.com	lakersnation	
landgrantholyland.com	Landgrant33	
landsofamerica.com	landsofamerica	
latinpost.com	Latin_Post	
latourist.com	latourist	
littlehouseliving.com	lhliving	
lifeloveandsugar.com	Life_Love_Sugar	
lifeandtimes.com	lifeandtimes	
likecool.com	likecool	
livebinders.com	livebinders	
localmemphis.com	localmemphis	
localnews8.com	localnews8	
logotv.com	logotv	
lolfanatic.com	LOLFanaticCom	
lombardiave.com	lombardiave	
lostlettermen.com	lostlettermen	
lostlettermen.com	lostlettermen	
lovebscott.com	lovebscott	
lovelyish.com	lovelyishblog	
lovemaegan.com	lovemaegan	
lovemeow.com	lovemeowdotcom	
m14forum.com	m14forum	
macaronikid.com	macaronikid	
macmillandictionary.com	macdictionary	
macheesmo.com	macheesmo	
maizenbrew.com	maizenbrew	
myhoustonmajic.com	majic1021	
makeandtakes.com	makeandtakes	
malibustrings.com	malibustrings	
muscleandfitnesshers.com	MandF_Hers	
marinij.com	marinij	
marshill.com	marshill	
meinmyplace.com	meinmyplace	
missinfo.tv	mekdot	
mercedsunstar.com	mercedsunstar	
messynessychic.com	messynessychic	
metroparent.com	metroparent	
mgoblog.com	mgoblog	
milehighreport.com	milehighreport	
minnpost.com	minnpost	
medicalmarijuana.com	mmdotcom	
mnfootballhub.com	mnfootballhub	
minnesotamonthly.com	MNMOmag	
modernfarmer.com	ModFarm	
mommyish.com	mommyishdotcom	
mommyshorts.com	mommyshorts	
moneyunder30.com	moneyunder30	
mp3boo.com	mp3boo	
mrcolionnoir.com	mrcolionnoir	
forwhomthecowbelltolls.com	mstatesports	
mun2.tv	mun2	
musicplayon.com	musicplayon	
musingsofamuse.com	musingsofamuse	
mwcconnection.com	mwcconnection	
myajc.com	myajctweets	
myarklamiss.com	myarklamiss	
myregistry.com	myregistry	
mysticlake.com	mysticlake	
nameberry.com	nameberry	
nationbuilder.com	nationbuilder	
naturallycurly.com	NaturallyCurly	
nbc15.com	nbc15_madison	
news8000.com	news8news	
news92fm.com	News92FM	
newschoolers.com	newschoolers	
newyork.com	newyorkcom	
nextmovie.com	NextMovie	
nflspinzone.com	nflspinzone	
nextimpulsesports.com	nimpulsesports	
ninersnation.com	NinersNation	
northlandsnewscenter.com	nncnow	
nofilmschool.com	nofilmschool	
nomnompaleo.com	nomnompaleo	
notcot.org	notcot	
notmartha.org	notmartha	
nowness.com	nowness	
nuggetry.com	nuggetry	
numerology.com	numerologycom	
nwahomepage.com	nwahomepage	
newyorkcomiccon.com	NY_Comic_Con	
nyulocal.com	nyulocal	
theoatmeal.com	oatmeal	
ocweekly.com	ocweekly	
ohgizmo.com	ohgizmo	
ohhappyday.com	ohhappyday	
ohmyveggies.com	ohmyveggies	
onlocationvacations.com	olv	
omtimes.com	omtimes	
oncewed.com	oncewed	
onenewspage.us	One_News_Page	
onebigphoto.com	onebigphoto	
openculture.com	openculture	
officialplaystationmagazine.co.uk	OPM_UK	
opposingviews.com	opposingviews	
orderup.com	orderuphq	
organicauthority.com	OrganicAuthorit	
ourdailybears.com	ourdailybears	
ourlads.com	Ourlads_Shonka	
outsideonline.com	outsidemagazine	
overthemonster.com	overthemonster	
pahomepage.com	pahomepage	
passiveaggressivenotes.com	panotes	
parentmap.com	parentmap	
pastapadre.com	pastapadre	
patdollard.com	patdollard	
patspulpit.com	patspulpit	
pauladeenstore.com	pauladeenstore	
paulaschoice.com	paulaschoice	
burntorangenation.com	PBatBON	
pbr.com	pbr	
pcgamesn.com	pcgamesn	
pep.ph	PEPalerts	
perfectgame.org	PerfectGameUSA	
persephonemagazine.com	persephone_mag	
petitelefant.com	petitelefant	
petstew.com	petstew	
pittsburghmagazine.com	PGHmagEAT	
thephoblographer.com	phoblographer	
phys.org	physorg_com	
dailypicksandflicks.com	picksandflicks	
pinchmysalt.com	pinchmysalt	
pinkberry.com	pinkberry	
pinkvilla.com	pinkvilla	
pinstripealley.com	pinstripealley	
pocketchangegourmet.com	PktChangGourmet	
playbill.com	playbill	
playboy.com	playboydotcom	
pocketables.com	pocketables	
pocketfives.com	pocketfives	
podbean.com	podbean_com	
pokecommunity.com	pokecommunity	
pokernews.com	pokernews	
portlandmonthlymag.com	PoMoMagazine	
popphoto.com	popphoto	
popville.com	popville	
mycolumbuspower.com	power1075	
practicallyfunctional.com	PracticallyF	
praisephilly.com	praisephilly	
pregnantchicken.com	pregnantchicken	
prekinders.com	prekinders	
prideofdetroit.com	prideofdetroit	
primalpalate.com	primalpalate	
primaryarms.com	primaryarms	
profilerehab.com	profilerehab	
projectnursery.com	projectnursery	
promotive.com	promotive	
prowrestling.net	prowrestlingnet	
prudentbaby.com	prudentbaby	
ps3news.com	PS3NewsDOTcom	
planetsave.com	psave	
blacksportsonline.com	PSicher	
psychologytoday.com	psychtoday	
ptable.com	ptable	
ptotoday.com	ptotoday	
pwtorch.com	pwtorch	
queerty.com	queerty	
racked.com	Racked	
rantlifestyle.com	RantLifestyle	
redtri.com	Red_Tricycle	
redalertpolitics.com	RedAlert	
redflagnews.com	redflagnews	
refinedhype.com	refinedhype	
rentjungle.com	rentjungle	
rentrange.com	rentrange	
instagr.in	renzyyy	
retrorenovation.com	retrorenovation	
returnofkings.com	returnofkings	
revengeofthebirds.com	revengeofbirds	
amazingribs.com	ribguy	
richmond.com	richmonddotcom	
rightthisminute.com	rightthisminute	
rigzone.com	rigzone	
riveraveblues.com	riveraveblues	
riversideonline.com	riversideonline	
realmenrealstyle.com	rmrstyle	
rnbxclusive.se	RnBXclusive_v3	
roadbikereview.com	roadbikereview	
roadkillcustoms.com	roadkillcustoms	
rolereboot.org	rolereboot	
rollbamaroll.com	rollbamaroll	
jimromenesko.com	romenesko	
runningintheusa.com	RunningInTheUSA	
rusticweddingchic.com	rusticwedchic	
sacurrent.com	sacurrent	
canalstreetchronicles.com	SaintsCSC	
sanduskyregister.com	sanduskyregistr	
sanjeevkapoor.com	sanjeevkapoor	
santikos.com	santikos	
saveur.com	saveurmag	
savorysweetlife.com	savorysweetlife	
independent.com	SBIndpndnt	
sbnation.com	sbnation	
scoringlive.com	scoringlive	
screenjunkies.com	screenjunkies	
scribd.com	scribd	
saturdaydownsouth.com	SDS	
clatl.com	search	
paloaltoonline.com	search	
seattlemet.com	seattlemet	
selectism.com	selectism	
truckertotrucker.com	semitrucks	
sew4home.com	sew4home	
sfappeal.com	sfappeal	
sfbg.com	sfbg	
sfstation.com	sfstation	
shaggybevo.com	shaggybevo	
shanghaiist.com	shanghaiist	
shanty-2-chic.com	shanty2chic	
shapeways.com	shapeways	
shiftgig.com	shiftgig	
shopwell.com	shopwell	
sigtalk.com	sigtalk	
siliconangle.com	siliconangle	
silverandblackpride.com	silverandblackp	
simplebites.net	simplebites	
somewhatsimple.com	SimpleStephD	
singletracks.com	singletrackscom	
thelandryhat.com	sinow	
slantmagazine.com	slant_magazine	
thesleuthjournal.com	sleuthjournal	
slowtwitch.com	slowtwitch	
socialmediaexaminer.com	smexaminer	
smithsonianmag.com	SmithsonianMag	
snapwidget.com	snapwidget	
sneakhype.com	sneakhype	
awsm.com	soawsm	
societyofchic.com	societyofchic	
societyandreligion.com	SocietyR	
sofrep.com	sofrep	
thespacelab.tv	SpacelabMusic	
spiritnow.com	spiritnow	
sweetpeaskitchen.com	SPKitchen	
splitsider.com	splitsider	
spoilertv.com	spoilertv	
spoonforkbacon.com	spoonforkbacon	
sportschatplace.com	sportschatplace	
sportsoverdose.com	sportsoverdose	
sportsvite.com	sportsvite	
spotzot.com	spotzot	
stampedeblue.com	stampedeblue	
stripes.com	starsandstripes	
statecollege.com	StateCollegecom	
statesymbolsusa.org	StateSymbolsUSA	
statisticbrain.com	statisticbrain	
statuecruises.com	statuecruises	
stayclassy.org	stayclassysd	
stealherstyle.net	stealherstyle_	
apstudynotes.org	StudyNotesApp	
styleblueprint.com	styleblueprint	
styleite.com	styleite	
styleweekly.com	styleweekly	
summertomato.com	summertomato	
supercook.com	super_cook	
surfermag.com	SURFER_Magazine	
surfingmagazine.com	surfingmagazine	
surnamedb.com	surnamedb	
svpply.com	svpply	
sweetopia.net	Sweetopia	
tabletmag.com	tabletmag	
takelessons.com	takelessons	
talkingchop.com	talkingchop	
tapastic.com	tapastic	
tasteandtellblog.com	tasteandtell	
tastespotting.com	tastespotting	
tdpri.com	tdpri	
slader.com	teamslader	
teamspeedkills.com	teamspeedkills	
technologytell.com	technologytell	
temptalia.com	temptalia	
tennisrecruiting.net	TennisRecNet	
texashsfootball.com	texashsfootball	
thatsnonsense.com	thatsnonsense	
theinertia.com	the_inertia	
therapinsider.com	the_rap_insider	
thebacklot.com	thebacklot	
thebeatdfw.com	thebeatdfw	
thebolditalic.com	thebolditalic	
thebudgetbabe.com	thebudgetbabe	
thecutekid.com	thecutekid	
thedailybanter.com	thedailybanter	
dailycurrant.com	TheDailyCurrant	
thedissolve.com	thedissolve	
theeverygirl.com	TheEverygirl_	
thefader.com	thefader	
thefalcoholic.com	thefalcoholic	
thefreshloaf.com	thefreshloaf	
theinspiredroom.net	theinspiredroom	
thejasminebrand.com	thejasminebrand	
latintimes.com	thelatintimes	
thelibertarianrepublic.com	thelibrepublic	
thelittlekitchen.net	thelittlekitchn	
thelmagazine.com	thelmagazine	
themarysue.com	TheMarySue	
thephinsider.com	thephinsider	
thepointsguy.com	thepointsguy	
theresurgence.com	theresurgence	
therundown.tv	therundown	
theshoegame.com	theshoegame	
theuntz.com	theuntz	
thezoereport.com	thezoereport	
thirstyroots.com	thirstyroots	
thisisrnb.com	thisisrnb	
thoughtcatalog.com	thoughtcatalog	
threadsmagazine.com	threadsmagazine	
thyblackman.com	thyblackman	
tidymom.net	TidyMom	
timetoast.com	timetoast	
inflexwetrust.com	TimWestwood	
tinyhouseblog.com	tinyhouseblog	
tinyhouselistings.com	tinyhouselist	
tinyurl.com	tinyurl	
nationalreport.net	TNROnline	
tomahawknation.com	tomahawknation	
tomandlorenzo.com	tomandlorenzo	
toonzone.net	toonzone	
top5.com	topfive	
totallyfreestuff.com	topsavings	
totalfratmove.com	totalfratmove	
touringplans.com	touringplans	
therealdeal.com	trdny	
trentonian.com	trentonian	
truebluela.com	truebluela	
tunefind.com	tunefind	
turfshowtimes.com	turfshowtimes	
uamshealth.com	uamshealth	
ucatholic.com	ucatholic	
universalhub.com	universalhub	
unlockit.co.nz	unlockitconz	
untappedcities.com	untappedcities	
upnorthlive.com	upnorthlive	
uptownmagazine.com	uptownmagazine	
urbandecay.com	urbandecay	
usacarry.com	usacarry	
usccb.org	usccb	
valuewalk.com	valuewalk	
verbalcommits.com	verbalcommits	
veria.com	Veria_Living	
vibrantnation.com	vibrantnation	
videomaker.com	videomaker	
vosizneias.com	vinnews	
visitkc.com	visitkc	
visual.ly	visually	
vitalmtb.com	vitalmtb	
vitalmx.com	vitalmx	
vivaelbirdos.com	vivaelbirdos	
vocero.com	voceropr	
wafflesatnoon.com	wafflesatnoon	
wbal.com	wbalradio	
wbls.com	wbls1075nyc	
wbng.com	WBNGActionNews	
dailylocal.com	wcdailylocal	
wctv.tv	wctv	
watertowndailytimes.com	wdtnews	
shewearsmanyhats.com	WearsManyHats	
web2carz.com	web2carz	
webosnation.com	webosnation	
weddinggawker.com	weddinggawker	
weddingmapper.com	weddingmapper	
weedmaps.com	weedmaps	
superskinnyme.com	weightloss2go	
westchestermagazine.com	westchestermag	
westerndigs.org	westerndigs	
totallyloveit.com	wetotallyloveit	
wegotthiscovered.com	wgtc_site	
wikigameguides.com	wikigameguides	
wilx.com	WILXTV	
windycitygridiron.com	WindyCGridiron	
wired2fish.com	wired2fish	
wishesmessages.com	wishesmessages	
wissports.net	wissportsnet	
witn.com	witn	
wjhg.com	WJHGTV2	
wktv.com	wktv	
womanfreebies.com	WomanFreebiesUS	
cartoonjr.com	WooJrKids	
workingperson.com	workingperson	
wpcentral.com	wpcentral	
wrdw.com	wrdw	
wsaw.com	wsaw	
wtok.com	wtoksports	
wweek.com	wweek	
elgenero.com	WWWELGENERO	
xclusiveszone.net	XclusivesZone	
xdtalk.com	xdtalk	
christinaaguilera.com	xtina	
yorkietalk.com	yorkietalk	
youlookfab.com	youlookfab	
your4state.com	your4state	
your-daily-girl.com	Yourdailygirl	
theyeshivaworld.com	ywn	
zhiphopcleveland.com	Z1079	
zam.com	ZAMofficial	
zeldadungeon.net	zeldadungeon	
addforums.com	addforums	
designsponge.com	designsponge	
downtrend.com	downtrendcom	
higherone.com	higherone	
idigitaltimes.com	idigitaltimes	
irishcentral.com	irishcentral	
jobamatic.com	jobamatic	
kinja.com	kinja	
liquor.com	liquor	
lyrster.com	lyrster	
medicaldaily.com	medicaldailycom	
nicoclub.com	nicoclub	
ohsheglows.com	ohsheglows	
polygon.com	polygon	
studyblue.com	studyblue	
thechivery.com	theCHIVERY	
worthpoint.com	worthpoint	
